70 70 70 70 70 70 70 70 70 70 70 70 70 70 70 70 70 70 70 70 70 70 70 70 70 70 70 70 70 70 70 70 70 70 70 70 70 70 70 70 70 70 70 70 70 70 70 70 70 70 
70 70 70 70 70 70 70 70 70 70 70 70 70 70 70 70 70 70 70 70 70 70 70 70 70 70 70 70 70 70 70 70 70 70 70 70 70 70 70 70 70 70 70 70 70 70 70 70 70 70 
70 70 70 70 70 70 70 70 70 70 70 70 70 70 70 70 70 70 70 70 70 70 70 70 70 70 70 70 70 70 70 70 70 70 70 70 70 70 70 70 70 70 70 70 70 70 70 70 70 70 
70 70 70 70 70 70 70 70 70 70 70 70 70 70 70 70 70 70 70 50 40 40 66 40 40 40 40 49 70 70 70 70 70 70 70 70 70 70 70 70 70 70 70 70 70 70 70 70 70 70 
70 70 70 70 70 70 70 70 70 70 70 70 70 70 70 70 50 40 40 46 1 0 51 0 0 0 0 45 40 40 49 70 70 70 70 70 70 70 70 70 70 70 70 70 70 70 70 70 70 70 
70 70 70 70 70 70 70 70 70 70 70 70 70 50 40 40 46 1 2 1 1 0 51 0 0 21 20 20 32 0 45 40 40 40 40 40 49 70 70 70 70 70 70 70 70 70 70 70 70 70 
70 70 70 70 70 70 70 70 70 70 70 50 40 46 0 0 0 1 1 1 0 0 51 0 0 19 93 71 71 71 71 71 91 0 0 0 45 49 70 70 70 70 70 70 70 70 70 70 70 70 
70 70 70 70 70 70 70 70 70 50 40 46 0 0 0 0 2 1 53 52 52 52 55 0 0 19 78 126 104 104 104 123 75 0 0 0 0 45 49 70 70 70 70 70 70 70 70 70 70 70 
70 70 70 70 70 70 70 70 50 46 0 0 0 0 0 1 1 1 51 1 1 2 0 0 0 19 78 110 126 104 123 107 75 166 162 167 0 0 45 40 49 70 70 70 70 70 70 70 70 70 
70 70 70 70 70 70 70 70 42 0 0 0 2 0 1 1 1 53 55 1 0 0 0 0 0 19 78 110 110 0 107 107 75 164 70 165 0 0 0 0 45 40 49 70 70 70 70 70 70 70 
70 70 70 70 70 70 70 70 42 0 0 0 0 0 2 2 2 51 1 1 2 0 0 0 0 19 78 110 110 0 107 107 75 168 163 169 0 0 0 0 0 0 45 49 70 70 70 70 70 70 
70 70 70 70 70 70 70 70 42 0 2 1 1 1 2 2 53 55 1 2 2 0 0 0 0 19 78 110 110 0 107 107 83 71 71 71 71 91 0 126 104 123 0 45 49 70 70 70 70 70 
70 70 70 70 70 70 70 70 42 0 1 1 1 1 1 2 51 1 1 1 0 0 0 0 0 19 78 110 110 0 107 115 104 104 104 104 123 75 31 110 2 107 0 0 41 70 70 70 70 70 
70 70 70 70 70 70 70 70 42 0 0 1 1 1 1 1 51 1 1 1 1 0 0 0 0 19 78 110 110 0 115 104 104 104 104 123 107 75 19 110 0 107 0 0 41 70 70 70 70 70 
70 70 70 70 70 70 70 70 42 0 0 1 2 1 2 53 55 0 1 2 0 0 0 0 0 19 78 110 110 0 0 0 0 0 0 107 107 75 19 110 2 107 0 0 41 70 70 70 70 70 
70 70 70 70 70 70 70 70 42 0 0 1 1 53 52 55 0 0 0 0 0 1 0 0 0 19 78 110 120 103 103 103 103 103 103 117 107 75 19 110 0 107 0 0 41 70 70 70 70 70 
70 70 70 70 70 70 70 70 42 0 0 1 1 62 1 0 0 0 0 2 1 2 0 0 0 19 78 120 103 103 103 103 103 103 103 103 117 75 19 110 2 107 0 0 41 70 70 70 70 70 
70 70 70 70 70 70 70 70 42 0 0 0 1 1 2 2 0 0 2 1 1 2 0 0 0 19 88 137 137 137 137 137 137 137 100 97 134 85 19 110 0 107 0 43 47 70 70 70 70 70 
70 70 70 70 70 70 70 50 46 0 0 1 0 0 0 0 0 2 2 1 1 1 0 0 0 19 0 0 0 13 34 14 0 0 96 95 133 0 19 110 2 107 0 41 70 70 70 70 70 70 
70 70 70 70 70 70 70 42 0 0 0 0 0 2 1 1 1 1 1 2 1 1 0 0 0 19 0 0 0 0 19 0 0 0 0 0 0 0 19 110 0 107 43 47 70 70 70 70 70 70 
70 70 70 70 70 70 70 42 0 0 0 2 1 1 1 1 1 1 1 1 1 1 0 0 0 25 20 20 20 20 28 20 20 20 20 20 20 20 24 110 2 107 41 70 70 70 70 70 70 70 
70 70 70 70 70 70 70 42 0 0 0 0 1 1 1 1 1 1 1 1 1 1 0 0 0 19 0 74 104 104 104 104 104 104 104 104 104 104 123 120 103 117 41 70 70 70 70 70 70 70 
70 70 70 70 70 70 70 42 0 0 0 0 0 1 1 1 1 1 1 1 1 1 2 0 0 19 0 107 2 0 2 0 2 0 2 0 2 0 107 0 0 0 45 49 70 70 70 70 70 70 
70 70 70 70 70 70 70 42 0 0 0 0 0 0 0 1 1 1 1 1 1 1 1 0 0 19 0 115 104 104 104 104 104 104 104 104 104 104 108 0 0 0 0 41 70 70 70 70 70 70 
70 70 70 70 70 70 50 46 0 0 0 0 0 0 0 0 0 0 0 0 2 1 0 0 11 35 12 0 0 0 0 0 0 0 0 0 0 0 0 0 2 0 0 41 70 70 70 70 70 70 
70 70 70 70 70 70 42 0 0 0 0 0 0 33 20 20 20 20 20 20 20 20 20 20 37 38 36 20 20 20 20 20 20 22 0 0 2 0 0 1 2 1 0 45 49 70 70 70 70 70 
70 70 70 70 70 50 46 0 0 0 0 0 0 0 0 0 0 0 0 0 1 2 0 0 13 34 14 0 0 0 2 2 0 23 22 0 0 2 2 1 1 1 0 0 41 70 70 70 70 70 
70 70 70 70 70 42 0 0 0 0 0 0 0 0 0 0 0 0 0 1 1 2 2 0 0 19 0 0 0 1 1 1 1 1 23 22 1 1 1 1 2 0 0 0 41 70 70 70 70 70 
70 70 70 70 70 42 0 0 0 0 0 0 0 0 0 0 0 0 1 1 1 1 1 1 1 19 1 1 1 1 1 2 1 1 1 23 22 11 7 12 1 2 0 0 41 70 70 70 70 70 
70 70 70 70 70 42 0 0 0 0 0 2 0 0 0 0 2 2 1 2 1 2 2 1 0 19 0 2 1 1 1 1 1 1 1 1 23 37 38 10 1 0 0 0 41 70 70 70 70 70 
70 70 70 70 70 42 0 0 0 0 0 0 0 1 1 1 1 2 2 1 1 1 2 0 0 19 0 0 0 0 0 2 1 1 1 1 1 13 8 14 2 0 0 0 41 70 70 70 70 70 
70 70 70 70 70 42 0 0 0 0 0 0 1 1 1 2 2 1 2 2 1 1 0 0 0 19 0 0 0 0 0 0 1 1 2 1 1 1 1 1 1 2 0 0 41 70 70 70 70 70 
70 70 70 70 70 48 44 0 0 0 0 0 1 1 1 1 2 2 1 2 2 1 0 0 0 30 0 0 0 0 0 0 2 1 1 1 2 1 2 1 1 2 0 0 41 70 70 70 70 70 
70 70 70 70 70 70 42 0 0 0 0 2 1 2 0 0 2 2 2 2 0 0 0 0 0 0 0 0 0 0 0 0 0 0 0 1 1 1 2 1 1 0 0 0 41 70 70 70 70 70 
70 70 70 70 70 70 42 0 0 0 0 1 2 0 0 0 0 1 1 0 0 0 0 0 0 0 0 0 0 0 0 2 0 0 0 0 1 2 1 1 2 0 0 0 41 70 70 70 70 70 
70 70 70 70 70 70 42 0 0 0 2 1 2 0 0 0 0 1 1 0 0 0 0 43 39 39 39 39 44 0 0 0 0 0 0 0 1 1 1 1 2 0 0 0 41 70 70 70 70 70 
70 70 70 70 70 70 42 0 0 0 2 0 0 0 0 0 2 2 43 39 39 39 39 47 70 70 70 70 48 39 39 44 0 0 0 0 0 1 2 2 0 0 0 0 41 70 70 70 70 70 
70 70 70 70 70 70 42 0 0 0 0 0 0 0 0 0 0 43 47 70 70 70 70 70 70 70 70 70 70 70 70 48 44 0 0 0 2 0 0 0 0 2 0 0 41 70 70 70 70 70 
70 70 70 70 70 70 42 0 0 0 2 0 0 0 0 0 43 47 70 70 70 70 70 70 70 70 70 70 70 70 70 70 48 44 0 0 0 0 0 0 0 0 0 0 41 70 70 70 70 70 
70 70 70 70 70 70 42 0 0 0 0 0 0 0 0 43 47 70 70 70 70 70 70 70 70 70 70 70 70 70 70 70 70 48 44 0 0 0 0 0 2 0 0 0 41 70 70 70 70 70 
70 70 70 70 70 70 42 0 0 0 0 0 0 0 43 47 70 70 70 70 70 70 70 70 70 70 70 70 70 70 70 70 70 70 48 44 0 0 0 0 0 0 0 0 41 70 70 70 70 70 
70 70 70 70 70 70 48 44 0 0 0 0 0 0 41 70 70 70 70 70 70 70 70 70 70 70 70 70 70 70 70 70 70 70 70 42 0 0 0 0 0 0 0 0 41 70 70 70 70 70 
70 70 70 70 70 70 70 42 0 0 0 0 0 43 47 70 70 70 70 70 70 70 70 70 70 70 70 70 70 70 70 70 70 70 70 42 0 0 0 0 0 0 0 0 41 70 70 70 70 70 
70 70 70 70 70 70 70 42 0 0 0 0 0 41 70 70 70 70 70 70 70 70 70 70 70 70 70 70 70 70 70 70 70 70 70 48 44 0 0 0 0 0 0 0 41 70 70 70 70 70 
70 70 70 70 70 70 70 42 0 0 0 0 43 47 70 70 70 70 70 70 70 70 70 70 70 70 70 70 70 70 70 70 70 70 70 70 48 44 0 0 0 0 0 0 41 70 70 70 70 70 
70 70 70 70 70 70 70 48 44 0 0 43 47 70 70 70 70 70 70 70 70 70 70 70 70 70 70 70 70 70 70 70 70 70 70 70 70 48 39 44 0 0 0 43 47 70 70 70 70 70 
70 70 70 70 70 70 70 70 48 39 39 47 70 70 70 70 70 70 70 70 70 70 70 70 70 70 70 70 70 70 70 70 70 70 70 70 70 70 70 48 44 0 43 47 70 70 70 70 70 70 
70 70 70 70 70 70 70 70 70 70 70 70 70 70 70 70 70 70 70 70 70 70 70 70 70 70 70 70 70 70 70 70 70 70 70 70 70 70 70 70 48 39 47 70 70 70 70 70 70 70 
70 70 70 70 70 70 70 70 70 70 70 70 70 70 70 70 70 70 70 70 70 70 70 70 70 70 70 70 70 70 70 70 70 70 70 70 70 70 70 70 70 70 70 70 70 70 70 70 70 70 
70 70 70 70 70 70 70 70 70 70 70 70 70 70 70 70 70 70 70 70 70 70 70 70 70 70 70 70 70 70 70 70 70 70 70 70 70 70 70 70 70 70 70 70 70 70 70 70 70 70 
