205 201 201 209 000 210 201 201 201 201 201 201 201 201 201 206
203 000 000 000 000 000 000 000 000 000 000 000 000 000 000 204
203 000 000 000 000 000 000 000 000 000 000 000 000 000 000 204
203 000 000 000 000 000 000 000 000 000 000 000 000 000 000 204
203 000 000 000 000 000 000 000 000 000 000 000 000 000 000 204
203 000 000 000 000 000 000 000 000 000 000 000 000 000 000 204
203 000 000 000 000 000 000 000 000 000 105 101 101 106 000 204
203 000 000 000 000 000 000 105 101 101 109 100 100 104 000 204
203 000 000 000 000 000 000 103 111 102 112 100 100 104 000 204
203 000 000 000 000 000 000 103 104 000 103 100 100 104 000 204
203 000 000 000 000 000 000 103 104 000 108 102 102 107 000 204
207 202 202 202 202 202 211 103 104 212 202 202 202 202 202 208

